1111111111111111111111111111111111111111
111X1X1X1X1X1X1X1X1111111111111111111111
1000000000000000000000000000000000000001
1000000000000000001111000000111111110001
1000000011000000001001000000100000010001
1001111111000000001000000000100100010001
1001000001000000001001000000100100010001
1001001001000000001111000000000111110001
1001001111000000000000000000000000000001
1001000000001011100000000000000000000001
100111111111100E0000C0000000000000000001
1000000000000011100000000001000000010001
1000000000000000000000000001111111110001
1000000000000000000000000000000000000001
1000010000010000000000000000000000000001
1000011111110000000000000000000000000001
1000000000000000000000000000000000000001
1000000000000001100111111000000000000001
1000000000000001000000001000000000000001
1000000000000000000P00000000000000000001
1111111111111111111111111111111111111111