1111111111111111111111111111111111111111
1P000000000000000000000000000000000000C1
1000000000000000000000000000000000000001
1000000000000000000000000000000000000001
1000000011111111110011111111110000000001
10000001X00000000000000000000X1000000001
1000000100000000000000000000001000000001
1000000100000000011100000000001000000001
1000000100000000100000000000001000000001
1000000100000001001100000000001000000001
100000000000000101E010000000000000000001
1000000100000001000010000000001000000001
1000000100000000111100000000001000000001
1000000100000000000000000000001000000001
1000000100000000000000000000001000000001
10000001X00000000000000000000X1000000001
1000000011111111110011111111110000000001
1000000000000000000000000000000000000001
1000000000000000000000000000000000000001
1C000000000000000000000000000000000000C1
1111111111111111111111111111111111111111

