1111111111111111111111111111111111111111
1C000000000000000000000000000000000001E1
1010010001001000001010010000000101000001
1010010000101000100010010000000101000001
1010010010010000001010010000000101000001
1010001001010100000100100000000100000001
1010010001001000000110010000000101000001
1001001001010010100010010C00000101000001
101001001001C00000101001X0000001010C0001
101001000100100000011001X000000101000001
100100100101000000001001X000000101000001
1010010001001000001010010000000101000001
10100100001010101000100100000001C1000001
1010010010010000000000011110111101000001
1010001001010101000100100000000101000001
1010010001001000000110010000000101000001
1001001001010010100010010000000101000001
100000000000000000000000000C000000000001
1000000000000000000000000000000000000001
1P000000000001001C00000000000000000000C1
1111111111111111111111111111111111111111