1111111111111111111111111111111111111111
1P000000000000000000000000000000000000C1
1000111111111111111111111111111111110001
10000001X0000000000000000000000000100001
1000000111111110000111111111111000100001
1000010000000000000100000000001000100001
1000010001111111000100000000001000100001
1001110001000000000100011110001000000001
10000000010011100011100000100010001X0001
1001111111001000001E10000010001000111111
10000000000010011110111100100010001X0001
1001111111001000000000000010000000000001
1000000000001001111111110010001000100001
1000000000001000000C00000010001000100001
1000000000001000000000000010001000000001
10000000000000000000000000000X1000100001
1000000001111111111111111111111000100001
1000000000000000000000000000000000100001
1000000000000000000000000000000000100001
1C000000000000000000000000000000001000C1
1111111111111111111111111111111111111111