1111111111111111111111111111111111111111
1E100000000000000000000000000000000000X1
1010010000000000000000000000000000000001
1000100000000000000000000000000000000001
1111000011111111110011111111110000000001
10000001C00000000000000000000C1000000001
1000000100000000000000000000001000000001
1000000100000000011100000000001000000001
1000000100000000100000000000001000000001
1000000100000001001100000000001000000001
100000000000000101P010000000000000000001
1000000100000001000010000000001000000001
1000000100000000111100000000001000000001
1000000100000000000000000000001000000001
1000000100000000000000000000001000000001
10000001C00000000000000000000C1000000001
1000000011111111110011111111110000000001
1000000000000000000000000000000000000001
1000000000000000000000000000000000000001
1X000000000000000000000000000000000000X1
1111111111111111111111111111111111111111