1111111111111111111111111111111111111111
1C000000000000000000000000000000000001E1
1010010001001000001010010000000101000001
1010010000101010100010010000000101000001
1010010010010000001010010000000101000001
1010001001010101000100100000000100000001
1010010001001000000110010000000101000001
1001001001010010100010010C00000101000001
101001001001C00000101001X0000001010C0001
101001000100100000011001X000000101000001
100100100101001010001001X000000101000C01
1010010001001000001010010000000101000001
10100100001010101000100100000001C1000001
10100100100100000010100111101111010C0001
1010001001010101000100100000000101000001
1010010001001000000110010000000101000001
1001001001010010100010010000000101000001
1000000000000000C0000000000C000000000001
1P001C100C0C01001C0000C00C000000000C0001
1111111111111111111111111111111111111111

