11111111
1P0C01E1
10000001
1001C101
11111111
