11111111111111
1P0C010E000001
10000000010001
1C11C1001000C1
11111111111111
