1111111111111111111111111111111111111111
1C000000000000000000000000000000000000E1
1010010001001000001010010000000101000001
1010010000101010100010010000000101000001
1010010010010000001010010000000101000001
1010001001010101000100100000000100000001
1010010001001000000110010000000101000001
1001001001010010100010010C00000101000001
1010010001001000001000010000000101000001
1010010000101010100010010000000101000001
101001001001C000001010010000000101000001
1010010001001000000110010000000101000001
1001001001010010100010010000000101000001
1010010001001000001010010000000101000001
10100100001010101000100100000001C1000001
1010010010010000001010011110111101000001
1010001001010101000100100000000101000001
1010010001001000000110010000000101000001
1001001001010010100010010000000101000001
1P00000000000000C0000000000C000000000001
1111111111111111111111111111111111111111